NO ./textures/u.xpm
SO ./textures/d.xpm
WE ./textures/r.xpm
EA ./textures/eagle.xpm

F 120,160,64

C 80,90,200

  1111111111111111111111  111111111
1111000000110000000000001    10000011
1011000001111111111111111    1111111
10010000000000000000000011111111
11111111101100000111000000000000111111
100000000011000001110111S01111111
10000000000000000000000000001
11110111111111011100000010001
11110111111111011101010010001
11000000110101011100000010001
10000000000000001100000010001
1000000000000000101010010001
1100000111110111111111000111
11110111    1110101 10111101
11111111 1111111 111111111111
111111111111111111111111111111